XXXXXXXXXXXXXXXXXXXXXXXXXXXXXXXXX
a............................XXXX
X.........X..................XXXX
X.........X.............XXXXXXXXX
X.......XX..............X........
X......X........b.......X...e....
X......X................X........
X...XXXX.....c..........XXXXXXXXX
X...........X.XX.XXXXXXXXX......X
X...........X.XXX.XXXXXXXX......X
X...........X.XXXX.XXXXXXX......X
X...........X.XXXXX.XXXXXX......X
X....................d..........X
X..................XXXXXXXXXXXX.X
XXXX.XXXXX.XXXXX.XXX............X
XX.....X.....X.....X.XXXXXXXXXXXX
XX.........g.X.....X............X
XX..h..X.....X...jfXXXXXXXXXXXX.X
XXXXXXXXXXXXXXXXXXXX............X
XXXXXXXXXXXXXXXXXXXXiXXXXXXXXXXXX
